6000
480
100000000001000
100000000001000
110000000001000
111000000001000
110000000001000
100000000001000
100000000001000
100000000001000
100000000001000
100000000001000
100000000001000
100000000001000
100000000001000
100000000001000
100005000001000
100000000001000
120000000001000
100000000001000
100000000001000
100000000001000
100000000001000
110000000001000
101000000001000
100000000001000
100100000001000
100100000001000
100001000000000
100000010000000
100000001000000
100000000000000
100000001000000
100000001000000
100000000000000
100000000100000
100000000100000
100000000100000
100000000001000
100000000001000
100010000001000
100110000001000
111112000001000
100110000001000
100010000001000
100000000001000
101000000001000
100010000000000
100010000000000
100000000000000
100000000000000
111100000000000
100000000000000
100000000000000
120010000000000
100010000000000
100000000000000
101000000000000
111100000000000
100000000000000
160000000010000
100000000100000
100000001000000
100100010000000
111111000000000
100000000000000
100000000000000
111000000090000
100000000000000
101111111111111
100010000000000
100000000000000
110000000000000
111010010000000
111113010000000
100000010000000
100001110000000
100000000000000
100000000000000
100400000000000
100000000000000
100000000000000
100100000000000
111110000000000
170000000000000
170001000000000
170001000000000
170001000000000
170000000080000
170000800000000
170000100000000
170000100000000
170000100000000
170000000000000
170000000000000
170000010000000
170000012000000
170000010000000
111111110000000
170000000000000
170000000000000
170000000000000
170010000000000
170010000000000
170000000000000
170000000000000
170100000000000
170100000000000
171000000000000
171000000000000
171200000000000
171000000000000
171000000000000
171000000000000
170100000000000
170100000000000
170000000000000
170000000000000
170010000000000
170010000000000
170000000000000
170000000000000
170001000000000
170001000000000
170000000000000
170000100000000
111111110000000
100000000000000
100010000000000
120010000000000
100000000000000
101000000000000
101000000000000
100000000000000
100000000000000
120000000000000
100000000000000
100000000000000
100000000000000
100000000000000
100000000000000
100000000000000
100000000000000
100000000000000
100000000000000
100000000000000
100000000000000
100000000000000
100000000000000
100000000000000
100000000000000
100000000000000
100000000000000
100000000000000
100000000000000
100000000000000
100000000000000
100000000000000
100000000000000
100000000000000
100000000000000
100000000000000
100000000000000
100000000000000
100000000000000
100000000000000
100000000000000
100000000000000
100000000000000
100000000000000
100000000000000
100000000000000
100000000000000
100000000000000
100000000000000
100000000000000
100000000000000
100000000000000
100000000000000
100000000000000
100000000000000
100000000000000
100000000000000
100000000000000
100000000000000
100000000000000
100000000000000
1D0000000000000
100000000000000
